30 30
1 1 1 1 1 1 1 1 1 1 1 1 1 1 1 1 1 1 1 1 1 1 1 1 1 1 1 1 1 1
1 1 1 1 1 1 1 1 1 1 1 1 1 1 1 1 1 1 1 1 1 1 1 1 1 1 1 1 1 1
1 1 1 1 1 1 1 1 1 1 1 1 1 1 1 1 1 1 1 1 1 1 1 1 1 1 1 1 1 1
1 1 1 1 1 1 1 1 1 1 1 1 1 1 1 1 1 1 1 1 1 1 1 1 1 1 1 1 1 1
1 1 1 1 1 1 1 1 1 1 1 1 1 1 1 1 1 1 1 1 1 1 1 1 1 1 1 1 1 1
1 1 1 1 1 1 1 1 1 1 1 1 1 1 1 1 1 1 1 1 1 1 1 1 1 1 1 1 1 1
1 1 1 1 1 1 1 1 1 1 1 1 1 1 1 1 1 1 1 1 1 1 1 1 1 1 1 1 1 1
1 1 1 1 1 1 1 1 1 1 1 1 1 1 1 1 1 1 1 1 1 1 1 1 1 1 1 1 1 1
1 1 1 1 1 1 1 1 1 1 1 1 1 1 1 1 1 1 1 1 1 1 1 1 1 1 1 1 1 1
1 1 1 1 1 1 1 1 1 1 1 1 1 1 1 1 1 1 1 1 1 1 1 1 1 1 1 1 1 1
1 1 1 1 1 1 1 1 1 1 1 1 1 1 1 1 1 1 1 1 1 1 1 1 1 1 1 1 1 1
1 1 1 1 1 1 1 1 1 1 1 1 1 1 1 1 1 1 1 1 1 1 1 1 1 1 1 1 1 1
1 1 1 1 1 1 1 1 1 1 1 1 1 1 1 1 1 1 1 1 1 1 1 1 1 1 1 1 1 1
1 1 1 1 1 1 1 1 1 1 1 1 1 1 1 1 1 1 1 1 1 1 1 1 1 1 1 1 1 1
1 3 1 1 1 1 1 1 1 1 1 1 1 1 1 1 1 1 1 1 1 1 1 1 1 1 1 1 1 1
1 1 1 1 1 1 1 1 1 1 1 1 1 1 1 1 1 1 1 1 1 1 1 1 1 1 1 1 1 1
1 1 1 1 1 1 1 1 1 1 1 1 1 1 1 1 1 1 1 1 1 1 1 1 1 1 1 1 1 1
1 1 1 1 1 1 1 1 1 1 1 1 1 1 1 1 1 1 1 12 1 1 1 1 1 1 1 13 1 1
1 1 1 1 1 1 1 1 1 1 1 1 1 1 1 1 1 9 1 13 4 1 1 1 6 5 11 12 6 1
1 1 1 10 1 1 9 1 1 1 1 1 1 1 20 21 0 0 0 0 0 19 1 1 6 1 10 4 6 6
0 0 0 0 0 0 0 0 0 0 0 0 14 14 2 16 16 17 17 16 16 16 0 0 0 0 0 0 0 0
2 17 16 16 16 16 16 16 17 16 16 7 1 1 2 16 16 16 16 17 16 16 17 17 17 17 16 16 16 7
2 16 17 17 16 16 16 16 16 17 17 17 1 1 16 17 17 16 17 17 16 16 16 16 17 16 16 16 17 7
2 16 16 16 17 16 17 16 16 16 16 16 1 1 17 16 17 16 16 17 17 16 16 16 16 16 16 17 17 7
2 16 16 16 16 16 17 17 17 17 17 16 1 1 17 16 17 16 17 16 17 16 16 16 17 17 17 17 16 7
2 17 17 17 16 17 17 16 16 16 17 16 1 1 17 16 17 16 16 16 17 16 16 16 17 16 17 17 16 7
2 16 16 17 17 17 16 16 16 16 17 16 1 1 17 16 16 16 16 16 16 16 17 17 17 16 17 17 16 7
2 16 16 16 16 17 17 17 17 16 17 16 1 1 17 16 16 16 17 16 17 16 17 17 16 17 16 16 16 7
2 16 16 16 16 16 16 16 17 17 16 17 1 1 16 16 17 16 17 17 17 16 16 16 17 16 16 17 16 7
2 17 16 16 16 16 17 17 17 17 16 16 1 1 16 16 16 16 16 16 17 17 17 17 17 17 17 16 16 7