200 30
1 1 1 1 1 1 1 1 1 1 1 1 1 1 1 1 1 1 1 1 1 1 1 1 1 1 1 1 1 1 1 1 1 1 1 1 1 1 1 1 1 1 1 1 1 1 1 1 1 1 1 1 1 1 1 1 1 1 1 1 1 1 1 1 1 1 1 1 1 1 1 1 1 1 1 1 1 1 1 1 1 1 1 1 1 1 1 1 1 1 1 1 1 1 1 1 1 1 1 1 1 1 1 1 1 1 1 1 1 1 1 1 1 1 1 1 1 1 1 1 1 1 1 1 1 1 1 1 1 1 1 1 1 1 1 1 1 1 1 1 1 1 1 1 1 1 1 1 1 1 1 1 1 1 1 1 1 1 1 1 1 1 1 1 1 1 1 1 1 1 1 1 1 1 1 1 1 1 1 1 1 1 1 1 1 1 1 1 1 1 1 1 1 1 1 1 1 1 1 1
1 1 1 1 1 1 1 1 1 1 1 1 1 1 1 1 1 1 1 1 1 1 1 1 1 1 1 1 1 1 1 1 1 1 1 1 1 1 1 1 1 1 1 1 1 1 1 1 1 1 1 1 1 1 1 1 1 1 1 1 1 1 1 1 1 1 1 1 1 1 1 1 1 1 1 1 1 1 1 1 1 1 1 1 1 1 1 1 1 1 1 1 1 1 1 1 1 1 1 1 1 1 1 1 1 1 1 1 1 1 1 1 1 1 1 1 1 1 1 1 1 1 1 1 1 1 1 1 1 1 1 1 1 1 1 1 1 1 1 1 1 1 1 1 1 1 1 1 1 1 1 1 1 1 1 1 1 1 1 1 1 1 4 4 11 11 6 12 5 5 13 6 1 1 1 1 1 1 1 1 1 1 1 1 1 1 1 1 1 1 1 1 1 1 1 1 1 1 1 1
1 1 1 1 1 1 1 1 1 1 1 1 1 1 1 1 1 1 1 1 1 1 1 1 1 1 1 1 1 1 1 1 1 1 1 1 1 1 1 1 1 1 1 1 1 1 1 1 1 1 1 1 1 1 1 1 1 1 1 1 1 1 1 1 1 1 1 1 1 1 1 1 1 1 1 1 1 1 1 1 1 1 1 1 1 1 1 1 1 1 1 1 1 1 1 1 1 1 1 1 1 1 1 1 1 1 1 1 1 1 1 1 1 1 1 1 1 1 1 1 1 1 1 1 1 1 1 1 1 1 1 1 1 1 1 1 1 1 1 1 1 1 1 1 1 1 1 1 1 1 1 1 1 1 1 1 1 1 1 1 1 1 1 1 12 6 13 6 6 6 13 6 1 1 1 1 1 1 1 1 1 1 1 1 1 1 1 1 1 1 1 1 1 1 1 1 1 1 1 1
1 1 1 1 1 1 1 1 1 1 1 1 1 1 1 1 1 1 1 1 1 1 1 1 1 1 1 1 1 1 1 1 1 1 1 1 1 1 1 1 1 1 1 1 1 1 1 1 1 1 1 1 1 1 1 1 1 1 1 1 1 1 1 1 1 1 1 1 1 1 1 1 1 1 1 1 1 1 1 1 1 1 1 1 1 1 1 1 1 1 1 1 1 1 1 1 1 1 1 1 1 1 1 1 1 1 1 1 1 1 1 1 1 1 1 1 1 1 1 1 1 1 1 1 1 1 1 1 1 1 1 1 1 1 1 1 1 1 1 1 1 1 1 1 1 1 1 1 1 1 1 1 1 1 1 1 1 1 1 1 1 1 1 1 13 4 6 13 13 13 13 13 1 1 1 1 1 1 1 1 1 1 1 1 1 1 1 1 1 1 1 1 1 1 1 1 1 1 1 1
1 1 1 1 1 1 1 1 1 1 1 1 1 1 1 1 1 1 1 1 1 1 1 1 1 1 1 1 1 1 1 1 1 1 1 1 1 1 1 1 1 1 1 1 1 1 1 1 1 1 1 1 1 1 1 1 1 1 1 1 1 1 1 1 1 1 1 1 1 1 1 1 1 1 1 1 1 1 1 1 1 1 1 1 1 1 1 1 1 1 1 1 1 1 1 1 1 1 1 1 1 1 1 1 1 1 1 1 1 1 1 1 1 1 1 1 1 1 1 1 1 1 1 1 1 1 1 1 1 1 1 1 1 1 1 1 1 1 1 1 1 1 1 1 1 1 1 1 11 1 1 1 1 1 1 1 1 1 1 1 1 1 4 12 13 5 6 4 13 6 5 13 1 1 1 1 1 1 1 1 1 1 1 1 1 1 1 1 1 1 1 1 1 1 1 1 1 1 1 1
1 1 1 1 1 1 1 1 1 1 1 1 1 1 1 1 1 1 1 1 1 1 1 1 1 1 1 1 1 1 1 1 1 1 1 1 1 1 1 1 1 1 1 1 1 1 1 1 1 1 1 1 1 1 1 1 1 1 1 1 1 1 1 1 1 1 1 1 1 1 1 1 1 1 1 1 1 1 1 1 1 1 1 1 1 1 1 1 1 1 1 1 1 1 1 1 1 1 1 1 1 1 1 1 1 1 1 1 1 1 1 1 1 1 1 1 1 1 1 1 1 1 1 1 1 1 1 1 1 1 1 1 1 1 1 1 1 1 1 1 1 1 1 1 1 1 1 1 1 1 1 1 1 1 1 1 1 1 1 1 1 1 1 1 13 4 12 12 13 4 6 13 1 1 1 1 1 1 1 1 1 1 1 1 1 1 1 1 1 1 1 1 1 1 1 1 1 1 1 1
1 1 1 1 1 1 1 1 1 1 1 1 1 1 1 1 1 1 1 1 1 1 1 1 1 1 1 1 1 1 1 1 1 1 1 1 1 1 1 1 1 1 1 1 1 1 1 1 1 1 1 1 1 1 1 1 1 1 1 1 1 1 1 1 1 1 1 1 1 1 1 1 1 1 1 1 1 1 1 1 1 1 1 1 1 1 1 1 1 1 1 1 1 1 1 1 1 1 1 1 1 1 1 1 1 1 1 1 1 1 1 1 1 1 1 1 1 1 1 1 1 1 1 1 1 1 1 1 1 1 1 1 1 1 1 1 1 1 1 1 1 1 1 11 1 1 1 1 1 1 1 1 5 1 1 1 1 1 1 1 1 1 1 1 6 4 6 12 6 6 12 6 1 1 1 1 1 1 1 1 1 1 1 1 1 1 1 1 1 1 1 1 1 1 1 1 1 1 1 1
1 1 1 1 1 1 1 1 1 1 1 1 1 1 1 1 1 1 1 1 1 1 1 1 1 1 1 1 1 1 1 1 1 1 1 1 1 1 1 1 1 1 1 1 1 1 1 1 1 1 1 1 1 1 1 1 1 1 1 1 1 1 1 1 1 1 1 1 1 1 1 1 1 1 1 1 1 1 1 1 1 1 1 1 1 1 1 1 1 1 1 1 1 1 1 1 1 1 1 1 1 1 1 1 1 1 1 1 1 1 1 1 1 1 1 1 1 1 1 1 1 1 1 1 1 1 1 1 1 1 1 1 1 1 1 1 1 1 1 1 1 1 1 1 1 1 1 1 1 1 1 1 1 1 1 1 1 4 4 1 1 1 6 6 6 11 13 12 12 4 5 6 1 1 1 1 1 1 1 1 1 1 1 1 1 1 1 1 1 1 1 1 1 1 1 1 1 1 1 1
1 1 1 1 1 1 1 1 1 1 1 1 1 1 1 1 1 1 1 1 1 1 1 1 1 1 1 1 1 1 1 1 1 1 1 1 1 1 1 1 1 1 1 1 1 1 1 1 1 1 1 1 1 1 1 1 1 1 1 1 1 1 1 1 1 1 1 1 1 1 1 1 1 1 1 1 1 1 1 1 1 1 1 1 1 13 1 6 1 13 1 1 1 1 1 1 1 1 1 1 1 1 1 1 1 1 1 1 1 1 1 1 1 1 1 1 1 1 1 1 1 1 1 1 1 1 1 1 1 1 1 1 1 1 1 1 1 1 1 6 1 1 1 1 1 1 1 1 1 1 1 1 1 1 1 1 1 12 6 1 1 1 4 6 4 12 12 12 6 13 13 6 1 1 1 1 1 1 1 1 1 1 1 1 1 1 1 1 1 1 1 1 1 1 1 1 1 1 1 1
1 1 1 1 1 1 1 1 1 1 1 1 1 1 1 1 1 1 1 1 1 1 1 1 1 1 1 1 1 1 1 1 1 1 1 1 1 1 1 1 1 1 1 1 1 1 1 1 1 1 1 1 1 1 1 1 1 1 1 1 1 1 1 1 1 1 1 1 1 1 1 1 1 1 1 1 1 1 1 1 1 1 1 1 1 6 6 6 13 6 1 1 1 1 1 1 1 1 1 1 1 1 1 1 1 1 1 1 1 1 1 1 1 1 1 1 1 1 1 1 1 1 1 1 1 1 1 1 1 1 1 1 1 1 1 1 1 1 5 13 1 1 1 1 1 1 1 1 1 1 1 1 1 1 1 1 1 6 4 1 1 1 12 12 4 6 6 4 6 13 12 12 1 1 1 1 1 1 1 1 1 1 1 1 1 1 1 1 1 1 1 1 1 1 1 1 1 1 1 1
1 1 1 1 1 1 1 1 1 1 1 1 1 1 1 1 1 1 1 1 1 1 1 1 1 1 1 1 1 1 1 1 1 1 1 1 1 1 1 1 1 1 1 1 1 1 1 1 1 1 1 1 1 1 1 1 1 1 1 1 1 1 1 1 1 1 1 1 1 1 1 1 1 1 1 1 1 1 1 1 1 1 1 1 1 12 5 6 11 12 1 1 1 1 1 1 1 1 1 1 1 1 1 1 1 1 1 1 1 1 1 1 1 1 1 1 1 1 1 1 1 1 1 1 1 1 1 1 1 1 1 1 1 1 1 1 1 1 1 6 1 1 1 1 1 1 1 1 1 1 1 1 1 1 1 1 1 6 4 1 1 1 6 6 6 12 6 6 6 6 12 6 1 1 1 1 1 1 1 1 1 1 1 1 1 1 1 1 1 1 1 1 1 1 1 1 1 1 1 1
1 1 1 1 1 1 1 1 1 1 1 1 1 1 1 1 1 1 1 1 1 1 1 1 1 1 1 1 1 1 1 1 1 1 1 1 1 1 1 1 1 1 1 1 1 1 1 1 1 1 1 1 1 1 1 1 1 1 1 1 1 1 1 1 1 1 1 1 1 1 1 1 1 1 1 1 1 1 1 1 1 1 1 1 1 6 12 13 13 6 1 1 1 1 1 1 1 1 1 1 1 1 1 1 1 1 1 1 1 1 1 1 1 1 1 1 1 1 1 1 1 1 1 1 1 1 1 1 1 1 1 1 0 1 1 0 0 0 0 0 0 0 0 0 0 0 0 0 0 0 0 0 0 0 0 0 0 0 0 1 1 1 8 8 8 8 8 8 8 8 8 8 1 1 1 1 1 1 1 1 1 1 1 1 1 1 1 1 1 1 1 1 1 1 1 1 1 1 1 1
1 1 1 1 1 1 1 1 1 1 1 1 1 1 1 1 1 1 1 1 1 1 1 1 1 1 1 1 1 1 1 1 1 1 1 1 1 1 1 1 1 1 1 1 1 1 1 1 1 1 1 1 1 1 1 1 1 1 1 1 1 1 1 1 1 1 1 0 0 1 1 1 1 1 1 1 1 1 1 1 1 1 1 1 1 6 13 6 13 6 1 1 1 1 1 1 1 1 1 1 1 1 1 1 1 1 1 1 1 1 1 1 1 1 1 1 1 1 1 1 1 1 1 1 1 1 1 1 1 1 1 1 2 1 1 2 16 16 16 16 16 16 16 16 16 16 16 16 16 16 16 16 16 17 16 16 16 16 16 1 1 1 2 17 16 16 16 17 17 16 16 7 1 1 1 1 1 1 1 1 1 1 1 1 1 1 1 1 1 1 1 1 1 1 1 1 1 1 1 1
1 1 1 1 1 1 1 1 1 1 1 1 1 1 1 1 1 1 1 1 1 1 1 1 1 1 1 1 1 1 1 1 1 1 1 1 1 1 1 1 1 1 1 1 1 1 6 1 1 1 1 1 1 1 1 1 1 1 1 1 1 1 1 1 1 1 5 2 7 5 1 1 1 1 1 1 1 1 1 1 1 1 1 1 1 13 11 6 11 6 1 1 1 1 1 1 1 1 1 1 1 1 1 1 1 1 1 1 1 1 13 11 1 1 1 1 1 1 1 1 1 1 1 1 1 1 1 1 1 1 1 1 2 1 1 2 16 17 17 16 16 16 16 16 16 16 16 16 16 16 16 16 16 17 17 16 16 16 16 1 1 1 2 16 16 17 17 17 17 16 16 7 1 1 1 1 1 1 1 1 1 1 1 1 1 1 1 1 1 1 1 1 1 1 1 1 1 1 1 1
1 3 1 1 1 1 1 1 1 1 1 1 1 1 1 1 1 1 1 1 1 1 1 1 1 1 1 1 1 1 1 1 1 1 1 1 1 1 1 13 1 1 1 1 1 1 6 11 1 1 1 1 1 1 1 1 1 1 1 1 1 1 1 1 1 1 1 2 7 1 1 1 1 1 1 1 1 1 1 1 1 1 1 1 1 13 4 4 4 4 1 1 1 1 1 1 1 1 1 1 1 1 5 6 1 1 1 1 1 1 13 1 1 1 1 1 1 1 1 1 1 1 1 1 1 1 1 1 1 1 1 1 2 1 1 2 16 2 17 17 17 17 16 17 16 16 16 16 16 16 17 17 17 17 16 17 16 16 16 1 1 1 2 16 17 17 16 16 17 17 17 7 1 1 1 1 1 1 1 1 1 1 1 1 1 1 1 1 1 1 1 1 1 1 1 1 1 1 1 1
1 1 1 1 1 1 1 1 1 1 1 1 1 1 1 1 1 1 1 1 1 1 1 1 1 1 1 1 1 1 1 1 1 1 1 1 1 1 1 6 12 1 1 1 1 1 4 1 4 1 1 1 1 1 1 1 1 1 1 1 1 1 1 1 1 1 1 2 7 1 1 1 1 1 1 1 1 1 1 1 1 1 1 1 1 13 6 13 6 4 1 1 1 1 1 11 6 5 1 1 1 1 1 4 1 1 1 1 1 1 4 1 1 1 1 1 1 1 1 1 1 1 1 1 1 1 1 1 1 1 1 1 2 1 1 2 16 2 16 16 16 17 17 17 16 16 17 17 17 17 16 16 16 17 16 16 17 16 16 1 1 1 2 16 17 16 16 17 17 16 16 7 1 1 1 1 1 1 1 1 1 4 1 1 1 1 1 1 1 1 1 1 1 1 1 1 1 1 1 1
1 1 1 1 1 1 1 1 1 1 1 1 1 1 1 1 1 1 1 1 1 1 1 1 1 1 1 1 1 1 1 1 1 1 1 1 1 1 1 4 6 1 1 1 1 1 4 11 12 1 1 1 1 1 1 1 1 1 1 1 1 1 18 0 0 0 0 0 0 0 0 0 0 0 0 0 0 0 0 0 0 0 0 0 0 0 0 0 0 0 0 19 1 1 1 1 6 1 1 1 1 1 1 4 1 1 1 1 1 1 6 1 1 1 1 1 1 1 1 1 1 1 1 1 1 1 1 1 1 1 1 1 2 1 1 2 16 16 16 17 16 17 17 16 16 17 17 17 16 17 17 17 17 17 16 16 16 17 16 1 1 1 1 1 1 1 1 1 1 1 1 1 1 1 1 1 4 1 1 1 1 6 1 1 1 1 1 1 1 1 1 1 1 1 1 6 1 1 1 1
1 1 1 1 1 1 1 1 1 1 1 1 1 1 1 1 1 1 1 12 1 1 1 1 1 1 1 13 1 1 1 1 1 1 1 1 1 1 1 13 6 1 1 1 1 1 4 5 6 1 1 1 1 1 1 1 1 1 1 1 1 18 16 16 16 16 16 16 16 16 17 17 17 16 16 16 16 16 16 16 16 16 16 16 16 16 16 16 16 16 16 7 1 1 1 1 4 1 1 1 1 1 1 1 1 1 1 1 1 1 6 1 1 1 1 1 1 1 1 1 1 1 1 1 1 1 1 1 1 1 1 1 1 1 1 2 16 16 16 16 17 17 16 16 16 16 16 17 17 17 17 17 17 17 16 17 17 17 16 1 1 1 1 1 1 1 1 1 1 1 1 1 1 1 1 1 6 1 1 1 1 6 1 1 1 1 1 1 1 1 1 1 5 12 4 13 1 1 1 1
1 1 1 1 1 1 1 1 1 1 1 1 1 1 1 1 1 9 1 13 4 1 1 1 6 5 11 12 6 1 1 1 6 1 1 1 1 1 1 6 12 6 1 1 1 1 12 1 13 1 1 1 1 1 1 1 1 1 1 1 18 16 16 17 17 16 16 16 17 17 17 16 17 17 17 16 16 16 16 16 16 16 17 17 17 16 16 16 16 16 16 7 1 1 1 1 6 5 1 1 1 1 1 1 1 1 1 1 18 0 0 0 19 1 1 1 1 1 1 1 1 1 1 1 1 1 1 1 1 1 1 1 1 15 15 2 16 16 17 17 17 17 16 17 17 16 16 17 16 16 16 17 17 16 16 16 16 16 16 1 1 1 1 1 1 1 1 1 1 1 1 1 1 1 1 5 6 5 1 1 1 6 1 1 1 1 1 1 1 1 1 1 1 6 11 6 1 1 1 1
1 1 1 10 1 1 9 1 1 1 1 1 1 1 20 21 0 0 0 0 0 19 1 1 6 1 10 4 6 6 1 1 4 1 1 1 1 1 1 6 13 12 1 1 1 1 4 12 13 1 1 1 1 1 1 1 1 1 20 21 16 16 17 16 16 17 17 17 17 16 16 16 16 16 17 16 16 17 17 17 17 17 17 17 17 16 16 16 16 16 16 7 1 1 1 1 4 1 1 1 1 18 0 0 0 0 0 0 17 17 17 17 17 19 1 1 1 1 1 1 1 1 1 1 1 1 1 1 1 1 20 21 8 8 8 16 16 16 16 16 16 16 16 16 16 16 16 17 16 16 16 17 17 17 17 17 16 16 16 1 1 1 1 1 1 1 1 1 1 1 1 1 1 1 1 1 13 1 1 1 1 13 1 1 1 1 1 1 1 1 1 1 1 4 12 13 1 1 1 1
0 0 0 0 0 0 0 0 0 0 0 0 14 14 2 16 16 17 17 16 16 16 0 0 0 0 0 0 0 0 0 0 0 0 0 0 0 0 0 0 0 0 0 1 1 0 0 0 0 0 0 0 1 1 1 0 0 0 17 16 16 16 17 16 16 17 16 16 16 16 16 16 16 16 17 17 17 16 17 16 16 16 16 16 16 16 16 16 16 16 16 16 0 0 0 0 0 0 0 0 0 16 16 16 16 16 17 17 17 16 17 17 16 16 0 0 0 0 0 0 0 0 0 0 0 0 0 0 0 0 16 16 17 17 17 16 16 16 16 16 16 16 16 17 16 16 16 17 16 16 16 16 16 16 16 16 16 16 16 0 0 0 0 0 0 0 0 0 0 0 0 0 0 0 0 0 0 0 0 0 0 0 0 0 0 0 0 0 0 0 0 0 0 0 0 0 0 0 0 0
2 17 16 16 16 16 16 16 17 16 16 7 1 1 2 16 16 16 16 17 16 16 17 17 17 17 16 16 16 16 16 16 16 16 16 16 16 16 16 16 16 16 7 1 1 2 16 16 16 16 16 7 1 1 1 2 16 16 16 17 17 17 17 17 17 17 17 17 17 17 16 16 17 17 17 16 16 17 17 17 16 16 16 16 16 16 16 16 16 16 16 16 17 17 17 16 16 16 16 16 16 16 16 16 16 17 17 17 16 16 17 17 17 17 17 17 16 16 17 17 17 16 16 16 16 16 16 16 16 16 16 16 16 17 16 16 16 17 17 16 16 16 16 16 16 16 17 16 17 16 16 16 17 16 16 16 16 16 16 16 16 16 16 16 16 17 16 16 16 16 16 16 16 16 16 16 16 16 16 16 17 16 16 16 16 16 16 16 16 16 16 16 17 17 17 16 16 17 16 16
2 16 17 17 16 16 16 16 16 17 17 17 1 1 16 17 17 16 17 17 16 16 16 16 17 16 16 16 17 16 16 16 16 17 17 17 17 17 17 17 17 17 7 1 1 17 17 17 17 17 16 7 1 1 1 2 17 16 16 17 16 16 16 16 16 16 16 16 16 16 17 17 16 16 16 16 16 16 16 16 16 16 16 16 16 17 17 17 17 17 17 17 16 16 16 16 16 17 17 17 17 17 17 17 17 16 16 17 16 16 16 16 16 16 16 17 17 17 17 17 17 16 16 16 17 16 16 16 16 17 17 17 17 16 16 16 16 17 17 17 16 16 16 16 16 17 17 16 17 17 17 17 17 16 16 16 16 16 16 16 16 16 16 17 17 17 17 16 16 16 16 16 16 16 16 16 16 16 17 17 17 16 16 16 16 16 16 16 16 17 17 17 17 16 16 16 16 17 17 16
2 16 16 16 17 16 17 16 16 16 16 16 1 1 17 16 17 16 16 17 17 16 16 16 16 16 16 17 17 16 16 16 17 17 17 17 17 16 16 17 17 17 7 1 1 17 17 17 16 16 16 17 1 1 1 2 17 16 16 17 17 17 17 17 17 16 16 16 17 17 17 17 17 16 16 16 16 16 16 16 16 17 17 17 17 16 16 16 16 16 16 16 16 17 16 17 16 16 16 17 17 17 16 17 16 16 16 17 16 16 16 16 17 17 16 16 16 17 17 16 16 16 16 17 17 16 16 16 17 17 16 16 16 16 16 16 16 16 17 16 17 17 17 16 17 17 16 16 16 16 16 17 16 16 17 17 17 17 17 17 16 17 17 17 16 16 16 16 16 16 16 17 17 17 17 17 17 17 17 17 16 16 17 17 17 17 17 17 17 17 17 16 16 16 16 16 16 17 17 17
2 16 16 16 16 16 17 17 17 17 17 16 1 1 17 16 17 16 17 16 17 16 16 16 17 17 17 17 16 16 16 16 17 17 17 17 17 16 16 17 16 17 7 1 1 2 16 17 17 16 17 17 1 1 1 2 16 17 17 17 17 17 17 17 16 17 16 17 17 16 16 16 16 17 16 16 16 17 17 17 17 17 16 17 17 17 17 17 17 17 17 17 17 17 17 17 17 17 17 16 16 16 16 17 17 16 16 17 16 16 17 17 17 17 17 16 16 16 16 17 17 16 16 17 17 17 17 17 17 16 16 16 16 16 16 16 16 17 16 17 17 17 16 17 17 17 16 17 17 16 16 16 17 17 17 17 17 16 16 17 17 17 16 16 16 16 16 16 16 16 17 17 17 16 16 17 17 17 17 16 16 17 17 16 17 17 17 17 17 17 17 17 16 17 17 17 17 17 16 16
2 17 17 17 16 17 17 16 16 16 17 16 1 1 17 16 17 16 16 16 17 16 16 16 17 16 17 17 16 16 16 16 17 17 16 16 16 17 17 17 16 17 7 1 1 1 1 1 1 1 1 1 1 1 1 2 16 17 17 17 16 16 16 16 17 17 17 17 16 17 17 17 17 17 17 17 17 17 16 16 16 17 17 17 16 16 16 16 16 16 16 17 17 17 17 17 17 17 17 17 17 17 17 17 17 16 16 17 16 17 17 17 16 16 17 16 16 16 16 16 16 17 17 17 17 17 16 16 17 17 16 16 16 16 16 16 17 17 17 16 16 16 17 16 16 17 17 17 17 16 16 17 17 17 16 17 17 16 16 17 17 17 16 16 16 16 16 16 17 17 17 17 16 16 16 16 16 16 16 16 16 17 17 17 17 17 17 16 17 17 17 17 17 17 17 17 16 17 16 16
2 16 16 17 17 17 16 16 16 16 17 16 1 1 17 16 16 16 16 16 16 16 17 17 17 16 17 17 16 16 16 17 17 17 17 17 17 17 17 17 17 17 7 1 1 1 1 1 1 1 1 1 1 1 1 2 16 17 17 17 17 16 16 16 17 17 17 17 16 17 17 17 17 17 17 17 17 17 17 16 17 17 16 17 17 16 16 16 16 17 17 17 17 17 17 17 17 17 17 16 17 17 16 16 17 17 16 17 17 17 17 16 17 17 17 17 17 17 16 16 16 16 17 17 17 16 16 16 16 17 17 17 17 17 17 17 17 16 16 16 17 17 16 16 17 17 17 17 17 16 17 17 17 17 17 17 16 16 17 17 16 17 17 17 17 17 17 17 17 16 17 17 17 17 16 16 16 17 17 17 17 17 17 17 16 16 16 16 16 17 17 17 17 17 17 16 17 16 16 16
2 16 16 16 16 17 17 17 17 16 17 16 1 1 17 16 16 16 17 16 17 16 17 17 16 17 16 16 16 16 16 17 17 16 16 17 17 17 17 17 16 17 16 8 8 8 8 8 8 8 8 8 8 8 8 16 17 17 17 17 17 17 16 17 17 16 16 16 16 17 17 16 16 17 17 16 16 16 16 16 16 16 17 17 17 17 17 17 17 16 16 16 16 16 16 16 17 17 17 17 17 17 17 17 17 17 16 16 17 17 17 17 17 17 17 16 17 17 17 17 17 17 17 17 17 17 16 16 16 16 16 16 17 17 17 16 16 16 16 17 17 16 16 16 16 17 17 16 16 16 17 17 17 17 17 17 17 17 17 16 16 17 17 16 17 17 17 17 16 16 17 17 17 17 17 17 17 17 17 16 16 16 16 16 16 16 16 16 16 17 16 16 16 17 16 16 17 16 16 16
2 16 16 16 16 16 16 16 17 17 16 17 1 1 16 16 17 16 17 17 17 16 16 16 17 16 16 17 16 16 16 16 17 17 17 17 17 17 17 17 17 17 17 16 16 16 16 16 16 16 17 17 17 17 17 16 16 16 16 16 16 17 17 17 17 16 16 16 16 16 16 17 17 17 16 17 17 17 16 16 16 16 16 16 17 17 16 16 16 16 16 16 16 16 16 16 16 16 17 17 17 17 16 17 17 17 16 16 16 16 16 16 16 16 16 16 16 16 16 16 16 16 17 16 16 17 17 17 17 17 17 17 16 16 16 16 16 16 17 17 16 16 16 16 16 17 17 16 17 17 17 16 16 16 16 16 16 17 17 17 17 17 16 16 16 16 16 17 17 17 17 16 16 16 16 16 16 16 16 16 16 16 16 16 16 16 16 16 16 17 17 16 16 16 16 17 17 16 16 16
2 17 16 16 16 16 17 17 17 17 16 16 8 8 16 16 16 16 16 16 17 17 17 17 17 17 17 16 16 16 16 16 16 16 16 16 16 16 16 16 16 16 16 16 16 17 17 17 17 17 17 16 16 16 17 16 16 16 16 16 16 16 16 16 16 17 17 16 17 17 17 17 16 16 16 16 16 16 17 17 17 17 17 17 17 16 16 16 16 16 16 16 16 16 16 16 16 16 16 16 16 16 17 17 16 16 16 16 16 16 16 16 16 16 16 16 16 16 16 16 16 16 17 17 17 17 17 17 16 16 16 16 16 16 16 16 16 16 16 16 16 16 16 16 16 16 16 16 16 16 16 16 16 16 16 16 16 16 16 16 16 16 16 16 16 16 16 16 16 16 16 16 16 16 16 16 16 16 16 16 16 16 16 16 16 16 16 16 16 16 16 17 17 17 17 16 16 16 16 16