170 30
1 1 1 1 1 1 1 1 1 1 1 1 1 1 1 1 1 1 1 1 1 1 1 1 1 1 1 1 1 1 1 1 1 1 1 1 1 1 1 1 1 1 1 1 1 1 1 1 1 1 1 1 1 1 1 1 1 1 1 1 1 1 1 1 1 1 1 1 1 1 1 1 1 1 1 1 1 1 1 1 1 1 1 1 1 1 1 1 1 1 1 1 1 1 1 1 1 1 1 1 1 1 1 1 1 1 1 1 1 1 1 1 1 1 1 1 1 1 1 1 1 1 1 1 1 1 1 1 1 1 1 1 1 1 1 1 1 1 1 1 1 1 1 1 1 1 1 1 1 1 1 1 6 13 11 6 11 6 6 1 1 1 1 1 1 1 1 1 1 1
1 1 1 1 1 1 1 1 1 1 1 1 1 1 1 1 1 1 1 1 1 1 1 1 1 1 1 1 1 1 1 1 1 1 1 1 1 1 1 1 1 1 1 1 1 1 1 1 1 1 1 1 1 1 1 1 1 1 1 1 1 1 1 1 1 1 1 1 1 1 1 1 1 1 1 1 1 1 1 1 1 1 1 1 1 1 1 1 1 1 1 1 1 1 1 1 1 1 1 1 1 1 1 1 1 1 1 1 1 1 1 1 1 1 1 1 1 1 1 1 1 1 1 1 1 1 1 1 1 1 1 1 1 1 1 1 1 1 1 1 1 1 1 1 1 1 1 1 1 1 1 1 1 6 6 6 6 6 1 1 1 1 1 1 1 1 1 1 1 1
1 1 1 1 1 1 1 1 1 1 1 1 1 1 1 1 1 1 1 1 1 1 1 1 1 1 1 1 1 1 1 1 1 1 1 1 1 1 1 1 1 1 1 1 1 1 1 1 1 1 1 1 1 1 1 1 1 1 1 1 1 1 1 1 1 1 1 1 1 1 1 1 1 1 1 1 1 1 1 1 1 1 1 1 1 1 1 1 1 1 1 1 1 1 1 1 1 1 1 1 1 1 1 1 1 1 1 1 1 1 1 1 1 1 1 1 1 1 1 1 1 1 1 1 1 1 1 1 1 1 1 1 1 1 1 1 1 1 1 1 1 1 1 1 1 1 1 1 1 1 1 1 6 6 6 6 6 6 6 1 1 1 1 1 1 1 1 1 1 1
1 1 1 1 1 1 1 1 1 1 1 1 1 1 1 1 1 1 1 1 1 1 1 1 1 1 1 1 1 1 1 1 1 1 1 1 1 1 1 1 1 1 1 1 1 1 1 1 1 1 1 1 1 1 1 1 1 1 1 1 1 1 1 1 1 1 1 1 1 1 1 1 1 1 1 1 1 1 1 1 1 1 1 1 1 1 1 1 1 1 1 1 1 1 1 1 1 1 1 1 1 1 1 1 1 1 1 1 1 1 1 1 1 1 1 1 1 1 1 1 1 1 1 1 1 1 1 1 1 1 1 1 1 1 1 1 1 1 1 1 1 1 1 1 4 4 4 1 1 1 1 1 6 6 11 6 11 6 6 1 1 1 1 1 1 1 1 1 1 1
1 1 1 1 1 1 1 1 1 1 1 1 1 1 1 1 1 1 1 1 1 1 1 1 1 1 1 1 1 1 1 1 1 1 1 1 1 1 1 1 1 1 1 1 1 1 1 1 1 1 1 1 1 1 1 1 1 1 1 1 1 1 1 1 1 1 1 1 1 1 1 1 1 1 1 1 1 1 1 1 1 1 1 1 1 1 1 1 1 1 1 1 1 1 1 1 1 1 1 1 1 1 1 1 1 1 1 1 1 1 1 1 1 1 1 1 1 1 1 1 1 1 1 1 1 1 1 1 1 1 1 1 1 1 1 1 1 1 1 1 1 1 1 1 4 4 4 1 1 1 1 1 6 6 6 6 6 6 6 1 1 1 1 1 1 1 1 1 1 1
1 1 1 1 1 1 1 1 1 1 1 1 1 1 1 1 1 1 1 1 1 1 1 1 1 1 1 1 1 1 1 1 1 1 1 1 1 1 1 1 1 1 1 1 1 1 1 1 1 1 1 1 1 1 1 1 1 1 1 1 1 1 1 1 1 1 1 1 1 1 1 1 1 1 1 1 1 1 1 1 1 1 1 1 1 1 1 1 1 1 1 1 1 1 1 1 1 1 1 1 1 1 1 1 1 1 1 1 1 1 1 1 1 1 1 1 1 1 1 1 1 1 1 1 1 1 1 1 1 1 1 1 1 1 1 1 1 1 1 1 1 1 1 11 4 4 4 1 1 1 1 1 1 6 6 6 6 6 1 1 1 1 1 1 1 1 1 1 1 1
1 1 1 1 1 1 1 1 1 1 1 1 1 1 1 1 1 1 1 1 1 1 1 1 1 1 1 1 1 1 1 1 1 1 1 1 1 1 1 1 1 1 1 1 1 1 1 1 1 1 1 1 1 1 1 1 1 1 1 1 1 1 1 1 1 1 1 1 1 1 1 1 1 1 1 1 1 1 1 1 1 1 1 1 1 1 1 1 1 1 1 1 1 1 1 1 1 1 1 1 1 1 1 1 1 1 1 1 1 1 1 1 1 1 1 1 1 1 1 1 1 1 1 1 1 1 1 1 1 1 1 1 1 1 1 1 1 1 1 1 1 1 1 1 4 4 4 11 1 1 1 1 6 6 11 6 11 6 6 1 1 1 1 1 1 1 1 1 1 1
1 1 1 1 1 1 1 1 1 1 1 1 1 1 1 1 1 1 1 1 1 1 1 1 1 1 1 1 1 1 1 1 1 1 1 1 1 1 1 1 1 1 1 1 1 1 1 1 1 1 1 1 1 1 1 1 1 1 1 1 1 1 1 1 1 1 1 1 1 1 1 1 1 1 1 1 1 1 1 1 1 1 1 1 1 1 1 1 1 1 1 1 1 1 1 1 1 1 1 1 1 1 1 1 1 1 1 1 1 1 1 1 1 1 1 1 1 1 1 1 1 1 1 1 1 1 1 1 1 1 1 1 1 1 1 1 1 1 1 1 1 1 1 1 4 4 4 1 1 1 1 1 1 6 6 6 6 6 1 1 1 1 1 1 1 1 1 1 1 1
1 1 1 1 1 1 1 1 1 1 1 1 1 1 1 1 1 1 1 1 1 1 1 1 1 1 1 1 1 1 1 1 1 1 1 1 1 1 1 1 1 1 1 1 1 1 1 1 1 1 1 1 1 1 1 1 1 1 1 1 1 1 1 1 1 1 1 1 1 1 1 1 1 1 1 1 1 1 1 1 1 1 1 1 1 13 1 6 1 13 1 1 1 1 1 1 1 1 1 1 1 1 1 1 1 1 1 1 1 1 1 1 1 1 1 1 1 1 1 1 1 1 1 1 1 1 1 1 1 1 1 1 1 1 1 1 1 6 1 1 1 1 1 1 4 4 4 1 1 1 1 1 6 6 6 6 6 6 6 1 1 1 1 1 1 1 1 1 1 1
1 1 1 1 1 1 1 1 1 1 1 1 1 1 1 1 1 1 1 1 1 1 1 1 1 1 1 1 1 1 1 1 1 1 1 1 1 1 1 1 1 1 1 1 1 1 1 1 1 1 1 1 1 1 1 1 1 1 1 1 1 1 1 1 1 1 1 1 1 1 1 1 1 1 1 1 1 1 1 1 1 1 1 1 1 6 6 6 13 6 1 1 1 1 1 1 1 1 1 1 1 1 1 1 1 1 1 1 1 1 1 1 1 1 1 1 1 1 1 1 1 1 1 1 1 1 1 1 1 1 1 1 1 1 1 1 5 6 5 1 1 1 1 1 4 4 4 1 1 1 1 1 6 6 6 6 6 6 6 1 1 1 1 1 1 1 1 1 1 1
1 1 1 1 1 1 1 1 1 1 1 1 1 1 1 1 1 1 1 1 1 1 1 1 1 1 1 1 1 1 1 1 1 1 1 1 1 1 1 1 1 1 1 1 1 1 1 1 1 1 1 1 1 1 1 1 1 1 1 1 1 1 1 1 1 1 1 1 1 1 1 1 1 1 1 1 1 1 1 1 1 1 1 1 1 12 5 6 11 12 1 1 1 1 1 1 1 1 1 1 1 1 1 1 1 1 1 1 1 1 1 1 1 1 1 1 1 1 1 1 1 1 1 1 1 1 1 1 1 1 1 1 1 1 1 1 1 6 22 22 22 22 22 22 4 4 4 1 1 1 1 1 6 6 6 6 6 6 6 1 1 1 1 1 1 1 1 1 1 1
1 1 1 1 1 1 1 1 1 1 1 1 1 1 1 1 1 1 1 1 1 1 1 1 1 1 1 1 1 1 1 1 1 1 1 1 1 1 1 1 1 1 1 1 1 1 1 1 1 1 1 1 1 1 1 1 1 1 1 1 1 1 1 1 1 1 1 1 1 1 1 1 1 1 1 1 1 1 1 1 1 1 1 1 1 6 12 13 13 6 1 1 1 1 1 1 1 1 1 1 1 1 1 1 1 1 1 1 1 1 1 1 1 1 1 1 1 1 1 1 1 1 1 1 1 1 1 1 1 1 5 1 0 1 1 0 0 0 0 0 0 0 0 0 0 0 0 0 0 1 1 1 0 0 0 0 0 0 0 1 1 1 1 1 1 1 1 1 1 1
1 1 1 1 1 1 1 1 1 1 1 1 1 1 1 1 1 1 1 1 1 1 1 1 1 1 1 1 1 1 1 1 1 1 1 1 1 1 1 1 1 1 1 1 1 1 1 1 1 1 1 1 1 1 1 1 1 1 1 1 1 1 1 1 0 0 1 1 1 1 1 1 1 1 1 1 1 1 1 0 0 1 1 1 1 6 13 6 13 6 1 1 1 1 1 1 1 1 1 1 1 1 1 1 1 1 1 1 1 1 1 1 1 1 1 1 1 1 1 1 1 1 1 1 1 1 1 1 1 1 1 1 2 1 1 2 16 16 16 16 16 16 16 16 16 16 17 16 7 1 1 1 2 16 16 16 16 16 16 1 1 1 1 1 1 1 1 1 1 1
1 1 1 1 1 1 1 1 1 1 1 1 1 1 1 1 1 1 1 1 1 1 1 1 1 1 1 1 1 1 1 1 1 1 1 1 1 1 1 1 1 1 1 1 1 1 6 1 1 1 1 1 1 1 1 1 1 1 1 1 1 1 1 5 2 7 5 1 1 1 1 1 1 1 1 1 1 1 5 2 7 5 1 1 1 13 11 6 11 6 1 1 1 1 1 1 1 1 1 1 1 1 1 1 1 1 1 1 1 1 13 11 1 1 1 1 1 1 1 1 1 1 1 1 1 1 1 11 1 1 1 1 2 1 1 2 16 17 17 16 16 16 16 16 17 16 16 17 7 1 1 1 2 16 16 16 17 16 16 1 1 1 1 1 1 1 1 1 1 1
1 3 1 1 1 1 1 1 1 1 1 1 1 1 1 1 1 1 1 1 1 1 1 1 1 1 1 1 1 1 1 1 1 1 1 1 1 1 1 13 1 1 1 1 1 1 6 11 1 1 1 1 1 1 1 1 1 1 1 1 1 1 1 1 2 7 1 1 1 1 1 1 1 1 1 1 1 1 1 2 7 1 1 1 1 13 4 4 4 4 1 1 1 1 1 1 1 1 1 1 1 1 5 6 1 1 1 1 1 1 13 1 1 1 1 1 1 1 1 1 1 1 1 1 1 1 1 1 1 1 1 1 2 1 1 2 16 16 17 17 17 17 16 17 16 16 16 16 7 1 1 1 2 17 17 17 16 16 17 1 1 1 1 1 1 1 1 1 1 1
1 1 1 1 1 1 1 1 1 1 1 1 1 1 1 1 1 1 1 1 1 1 1 1 1 1 1 1 1 1 1 1 1 1 1 1 1 1 1 6 12 1 1 1 1 1 4 1 4 1 1 1 1 1 1 1 1 1 1 1 1 1 1 1 2 7 1 1 22 22 1 1 1 1 1 22 22 1 1 2 7 1 1 1 1 13 6 13 6 4 1 1 1 1 1 11 6 5 1 1 1 1 1 4 1 1 1 1 1 1 4 1 1 1 1 1 1 1 1 1 1 1 1 1 11 1 1 1 1 1 1 1 2 1 1 2 16 17 16 16 16 17 17 17 16 16 17 17 7 1 1 1 2 16 17 16 16 16 16 1 1 1 1 1 1 1 4 1 1 1
1 1 1 1 1 1 1 1 1 1 1 1 1 1 1 1 1 1 1 1 1 1 1 1 1 1 1 1 1 1 1 1 1 1 1 1 1 1 1 4 6 1 1 1 1 1 4 11 12 1 1 1 1 1 1 1 1 1 1 1 1 1 18 0 0 0 0 0 0 0 0 0 0 0 0 0 0 0 0 0 0 0 0 0 0 0 0 0 0 0 0 19 1 1 1 1 6 1 1 1 1 1 1 4 1 1 1 1 1 1 6 1 1 1 1 1 1 1 1 11 4 4 4 1 1 1 1 1 1 1 1 1 2 1 1 2 16 16 16 17 16 17 17 16 16 17 17 17 7 1 1 1 2 16 16 16 16 16 17 1 1 1 1 1 1 5 4 1 1 1
1 1 1 1 1 1 1 1 1 1 1 1 1 1 1 1 1 1 1 12 1 1 1 1 1 1 1 13 1 1 1 1 1 1 1 1 1 1 1 13 6 1 1 1 1 1 4 5 6 1 1 1 1 1 1 1 1 1 1 1 1 18 17 16 16 16 16 16 16 16 17 17 17 16 16 16 16 16 16 16 16 16 16 16 16 16 16 16 16 16 16 7 1 1 1 1 4 1 1 1 1 1 1 1 1 1 1 1 1 22 6 1 1 1 1 1 1 1 1 1 4 4 4 1 1 1 1 1 1 1 1 1 1 1 1 2 16 16 16 16 17 17 16 16 16 16 16 17 7 1 1 1 2 16 16 16 17 16 16 1 1 1 1 1 1 1 4 1 1 1
1 1 1 1 1 1 1 1 1 1 1 1 1 1 1 1 1 9 1 13 4 1 1 1 6 5 11 12 6 1 1 1 6 1 1 1 1 1 1 6 12 6 1 1 1 1 12 1 13 1 1 1 1 1 1 1 1 1 1 1 18 16 16 17 17 16 16 16 17 17 17 16 17 17 17 16 16 16 16 16 16 16 17 17 17 16 16 16 16 16 16 7 1 1 1 1 6 5 1 1 1 1 1 1 1 1 1 1 18 0 0 0 19 1 1 1 1 1 1 1 4 4 4 1 1 1 1 1 1 1 1 1 1 15 15 2 16 16 17 17 17 17 16 17 17 16 16 17 7 1 1 1 2 17 16 16 16 17 16 1 1 1 4 1 1 1 4 1 1 1
1 9 1 1 1 22 1 10 1 22 22 1 1 1 20 21 0 0 0 0 0 19 1 1 6 1 10 4 6 6 9 1 4 22 22 22 22 22 22 6 13 12 1 1 1 1 4 12 13 1 10 1 1 1 1 1 9 1 20 21 16 16 17 16 16 17 17 17 17 16 16 16 16 16 17 16 16 17 17 17 17 17 17 17 17 16 16 16 16 16 16 7 1 1 1 1 4 22 1 1 1 18 0 0 0 0 0 0 17 17 17 17 17 19 22 22 1 1 22 22 4 4 4 1 1 1 1 1 22 22 20 21 8 8 8 16 16 16 16 16 16 16 16 16 16 16 16 17 16 1 1 1 1 1 1 1 1 1 1 1 1 1 4 11 1 1 4 5 1 1
0 0 0 0 0 0 0 0 0 0 0 0 14 14 2 16 16 17 17 16 16 16 0 0 0 0 0 0 0 0 0 0 0 0 0 0 0 0 0 0 0 0 0 1 1 0 0 0 0 0 0 0 1 1 1 0 0 0 17 16 16 16 17 16 16 17 16 16 16 16 16 16 16 16 17 17 17 16 17 16 16 16 16 16 16 16 16 16 16 16 16 16 0 0 0 0 0 0 0 0 0 16 16 16 16 16 17 17 17 16 17 17 16 16 0 0 0 0 0 0 0 0 0 0 0 0 0 0 0 0 16 16 17 17 17 16 16 16 16 16 16 16 16 17 16 16 16 17 7 1 1 1 1 1 1 1 1 1 1 1 1 11 4 1 1 1 4 1 1 1
2 17 16 16 16 16 16 16 17 16 16 7 1 1 2 16 16 16 16 17 16 16 17 17 17 17 16 16 16 16 16 16 16 16 16 16 16 16 16 16 16 16 7 1 1 2 16 16 16 16 16 7 1 1 1 2 16 16 16 17 17 17 17 17 17 17 17 17 17 17 16 16 17 17 17 16 16 17 17 17 16 16 16 16 16 16 16 16 16 16 16 16 17 17 17 16 16 16 16 16 16 16 16 16 16 17 17 17 16 16 17 17 17 17 17 17 16 16 17 17 17 16 16 16 16 16 16 16 16 16 16 16 16 17 16 16 16 17 17 16 16 16 16 16 16 16 17 16 17 1 1 1 1 1 1 1 1 1 1 1 1 1 4 1 1 1 4 1 1 1
2 16 17 17 16 16 16 16 16 17 17 17 1 1 16 17 17 16 17 17 16 16 16 16 17 16 16 16 17 16 16 16 16 17 17 17 17 17 17 17 17 17 7 1 1 17 17 17 17 17 16 7 1 1 1 2 17 16 16 17 16 16 16 16 16 16 16 16 16 16 17 17 16 16 16 16 16 16 16 16 16 16 16 16 16 17 17 17 17 17 17 17 16 16 16 16 16 17 17 17 17 17 17 17 17 16 16 17 16 16 16 16 16 16 16 17 17 17 17 17 17 16 16 16 17 16 16 16 16 17 17 17 17 16 16 16 16 17 17 17 16 16 16 16 16 17 17 16 17 1 1 1 1 1 1 1 1 1 1 1 1 1 4 1 1 1 4 1 1 1
2 16 16 16 17 16 17 16 16 16 16 16 1 1 17 16 17 16 16 17 17 16 16 16 16 16 16 17 17 16 16 16 17 17 17 17 17 16 16 17 17 17 7 1 1 17 17 17 16 16 16 17 1 1 1 2 17 16 16 17 17 17 17 17 17 16 16 16 17 17 17 17 17 16 16 16 16 16 16 16 16 17 17 17 17 16 16 16 16 16 16 16 16 17 16 17 16 16 16 17 17 17 16 17 16 16 16 17 16 16 16 16 17 17 16 16 16 17 17 16 16 16 16 17 17 16 16 16 17 17 16 16 16 16 16 16 16 16 17 16 17 17 17 16 17 17 16 16 16 16 16 17 16 16 16 16 16 16 16 16 16 16 16 17 16 16 16 16 16 16
2 16 16 16 16 16 17 17 17 17 17 16 1 1 17 16 17 16 17 16 17 16 16 16 17 17 17 17 16 16 16 16 17 17 17 17 17 16 16 17 16 17 7 1 1 2 16 17 17 16 17 17 1 1 1 2 16 17 17 17 17 17 17 17 16 17 16 17 17 16 16 16 16 17 16 16 16 17 17 17 17 17 16 17 17 17 17 17 17 17 17 17 17 17 17 17 17 17 17 16 16 16 16 17 17 16 16 17 16 16 17 17 17 17 17 16 16 16 16 17 17 16 16 17 17 17 17 17 17 16 16 16 16 16 16 16 16 17 16 17 17 17 16 17 17 17 16 17 16 16 16 16 16 16 17 16 16 16 17 16 16 16 16 16 16 16 16 16 16 16
2 17 17 17 16 17 17 16 16 16 17 16 1 1 17 16 17 16 16 16 17 16 16 16 17 16 17 17 16 16 16 16 17 17 16 16 16 17 17 17 16 17 7 1 1 1 1 1 1 1 1 1 1 1 1 2 16 17 17 17 16 16 16 16 17 17 17 17 16 17 17 17 17 17 17 17 17 17 16 16 16 17 17 17 16 16 16 16 16 16 16 17 17 17 17 17 17 17 17 17 17 17 17 17 17 16 16 17 16 17 17 17 16 16 17 16 16 16 16 16 16 17 17 17 17 17 16 16 17 17 16 16 16 16 16 16 17 17 17 16 16 16 17 16 16 17 17 17 16 16 17 16 16 16 16 16 16 16 16 16 16 17 16 16 16 16 16 16 16 16
2 16 16 17 17 17 16 16 16 16 17 16 1 1 17 16 16 16 16 16 16 16 17 17 17 16 17 17 16 16 16 17 17 17 17 17 17 17 17 17 17 17 7 1 1 1 1 1 1 1 1 1 1 1 1 2 16 17 17 17 17 16 16 16 17 17 17 17 16 17 17 17 17 17 17 17 17 17 17 16 17 17 16 17 17 16 16 16 16 17 17 17 17 17 17 17 17 17 17 16 17 17 16 16 17 17 16 17 17 17 17 16 17 17 17 17 17 17 16 16 16 16 17 17 17 16 16 16 16 17 17 17 17 17 17 17 17 16 16 16 17 17 16 16 17 17 17 17 17 16 16 16 16 16 16 16 16 16 16 16 16 16 17 16 16 16 17 16 16 16
2 16 16 16 16 17 17 17 17 16 17 16 1 1 17 16 16 16 17 16 17 16 17 17 16 17 16 16 16 16 16 17 17 16 16 17 17 17 17 17 16 17 16 8 8 8 8 8 8 8 8 8 8 8 8 16 17 17 17 17 17 17 16 17 17 16 16 16 16 17 17 16 16 17 17 16 16 16 16 16 16 16 17 17 17 17 17 17 17 16 16 16 16 16 16 16 17 17 17 17 17 17 17 17 17 17 16 16 17 17 17 17 17 17 17 16 17 17 17 17 17 17 17 17 17 17 16 16 16 16 16 16 17 17 17 16 16 16 16 17 17 16 16 16 16 17 17 16 17 16 16 16 16 16 16 16 16 16 16 16 16 16 16 16 16 16 16 16 16 16
2 16 16 16 16 16 16 16 17 17 16 17 1 1 16 16 17 16 17 17 17 16 16 16 17 16 16 17 16 16 16 16 17 17 17 17 17 17 17 17 17 17 17 16 16 16 16 16 16 16 17 17 17 17 17 16 16 16 16 16 16 17 17 17 17 16 16 16 16 16 16 17 17 17 16 17 17 17 16 16 16 16 16 16 17 17 16 16 16 16 16 16 16 16 16 16 16 16 17 17 17 17 16 17 17 17 16 16 16 16 16 16 16 16 16 16 16 16 16 16 16 16 17 16 16 17 17 17 17 17 17 17 16 16 16 16 16 16 17 17 16 16 16 16 16 17 17 16 17 17 16 16 17 16 16 16 16 16 16 16 16 16 16 16 16 16 16 16 16 16
2 17 16 16 16 16 17 17 17 17 16 16 8 8 16 16 16 16 16 16 17 17 17 17 17 17 17 16 16 16 16 16 16 16 16 16 16 16 16 16 16 16 16 16 16 17 17 17 17 17 17 16 16 16 17 16 16 16 16 16 16 16 16 16 16 17 17 16 17 17 17 17 16 16 16 16 16 16 17 17 17 17 17 17 17 16 16 16 16 16 16 16 16 16 16 16 16 16 16 16 16 16 17 17 16 16 16 16 16 16 16 16 16 16 16 16 16 16 16 16 16 16 17 17 17 17 17 17 16 16 16 16 16 16 16 16 16 16 16 16 16 16 16 16 16 16 16 16 16 16 16 16 16 16 16 16 16 16 16 16 16 16 16 16 16 16 16 16 16 16