35 15
1 1 1 1 1 1 1 1 1 1 1 1 1 1 1 1 1 1 1 1 1 1 1 1 1 1 1 1 1 1 1 1 1 1 1
1 1 1 1 1 1 1 1 1 1 1 1 1 1 1 1 1 1 1 1 1 1 1 1 1 1 1 1 1 1 1 1 1 1 1
1 1 1 1 1 1 1 1 1 1 1 1 1 1 1 1 1 8 8 8 8 8 8 8 8 8 1 1 1 1 1 1 1 3 1
1 1 1 1 1 1 1 1 1 1 1 1 1 1 1 1 5 8 8 8 8 8 8 8 8 8 6 1 1 1 1 1 1 1 1
1 1 1 1 1 1 1 1 1 1 1 1 1 1 1 1 1 8 8 8 8 8 8 8 8 8 1 1 1 1 1 1 1 1 1
1 1 1 1 1 1 1 1 1 1 1 1 1 1 1 1 5 8 8 8 8 8 8 8 8 8 6 1 1 1 1 1 1 1 1
1 1 1 1 1 1 1 1 1 1 1 1 1 1 1 1 1 8 8 8 8 8 8 8 8 8 1 1 1 1 1 1 1 1 1
1 1 15 15 15 1 1 1 1 1 1 1 1 1 1 1 5 8 8 8 8 8 8 8 8 8 6 1 1 1 1 2 1 1 1
1 15 15 15 15 15 1 1 1 1 1 1 1 1 1 1 1 1 1 1 7 7 7 1 1 1 1 1 1 1 2 2 2 1 1
1 15 15 15 15 15 1 1 1 1 1 1 1 1 1 5 11 11 11 11 7 7 7 1 1 1 1 1 1 2 2 2 2 2 1
15 15 15 15 15 15 15 1 1 1 1 1 1 1 1 1 1 1 1 1 7 7 7 1 1 1 1 1 2 2 2 2 2 2 2
15 15 15 12 15 15 15 1 1 1 1 1 1 1 1 1 1 1 1 1 7 12 7 1 1 1 1 2 2 2 2 12 2 2 2
0 0 0 0 0 0 0 0 0 0 0 0 0 0 0 0 0 0 0 0 0 0 0 0 0 0 0 0 0 0 0 0 0 0 0
0 0 0 0 0 0 0 0 0 0 0 0 0 0 0 0 0 0 0 0 0 0 0 0 0 0 0 0 0 0 0 0 0 0 0
2 2 2 2 2 2 2 2 2 2 2 2 2 2 2 2 2 2 2 2 2 2 2 2 2 2 2 2 2 2 2 2 2 2 2