35 15
1 1 1 1 1 1 1 1 1 1 1 1 1 1 1 1 1 1 1 1 1 1 1 1 1 1 1 1 1 1 1 1 1 1 1
1 1 1 1 1 1 1 1 1 1 1 1 1 1 1 1 8 8 8 8 8 1 1 1 1 1 1 1 1 1 1 1 1 1 1
1 1 1 1 1 1 1 1 1 1 1 1 1 1 1 8 8 8 8 8 8 8 1 1 1 1 1 1 1 1 1 1 1 3 1
1 1 1 1 1 1 1 1 1 1 1 1 1 1 8 8 8 8 8 8 8 8 8 1 1 1 1 1 1 1 1 1 1 1 1
1 1 1 1 1 1 1 1 1 1 1 1 1 1 8 8 8 8 8 8 8 8 8 1 1 1 1 1 1 1 1 1 1 1 1
1 1 1 1 1 1 1 1 1 1 1 1 1 1 8 8 8 8 8 8 8 8 8 1 1 1 1 1 1 1 1 1 1 1 1
1 1 1 1 1 1 1 1 1 1 1 1 1 1 8 8 8 8 8 8 8 8 8 1 1 1 1 1 1 1 1 1 1 1 1
1 1 1 1 1 21 1 1 1 1 1 1 1 1 8 1 1 23 23 23 1 1 8 1 1 1 1 1 22 22 22 1 1 1 1
1 1 1 1 21 21 21 1 1 1 1 1 1 1 1 1 1 23 23 23 1 1 1 1 1 1 1 22 22 22 22 22 1 1 1
1 1 1 21 21 21 21 21 1 1 1 1 1 1 1 1 1 23 23 23 1 1 1 1 1 1 22 22 22 22 22 22 22 1 1
1 1 21 21 21 21 21 21 21 1 1 1 1 1 1 1 1 23 23 23 1 1 1 1 1 1 22 22 22 22 22 22 22 1 1
1 21 21 21 21 21 21 21 21 21 1 1 1 10 1 9 10 23 23 23 10 1 9 1 1 1 22 22 22 22 22 22 22 1 1
0 0 0 0 0 0 0 0 0 0 0 0 0 0 0 0 0 0 0 0 0 0 0 0 0 0 0 0 0 0 0 0 0 0 0
0 0 0 0 0 0 0 0 0 0 0 0 0 0 0 0 0 0 0 0 0 0 0 0 0 0 0 0 0 0 0 0 0 0 0
2 2 2 2 2 2 2 2 2 2 2 2 2 2 2 2 2 2 2 2 2 2 2 2 2 2 2 2 2 2 2 2 2 2 2