25 30
11 33 33 33 33 33 33 33 33 33 33 33 33 33 33 33 33 33 33 33 33 33 33 33 33
11 33 33 33 33 33 33 33 33 33 33 33 33 33 33 33 33 33 33 33 33 33 33 33 33
11 33 33 33 33 33 33 33 33 33 33 33 33 33 33 33 33 33 33 33 33 33 33 33 33
11 33 33 33 33 33 33 33 33 33 33 33 33 33 33 33 33 33 33 33 33 33 33 33 33
11 33 33 33 33 33 33 33 33 33 33 33 33 33 33 33 33 33 33 33 33 33 33 33 33
11 33 33 33 33 33 33 33 33 33 33 33 33 33 33 33 33 33 33 33 33 33 33 33 33
11 33 33 33 33 33 33 33 33 33 33 33 33 33 33 33 33 33 33 33 33 33 33 33 33
11 33 33 33 33 33 33 33 33 33 33 33 33 33 33 33 33 33 33 33 33 33 33 33 33
11 33 33 33 33 33 33 33 33 33 33 33 33 33 33 33 33 33 33 33 33 33 33 33 33
11 33 33 33 33 33 33 33 33 33 33 33 33 33 33 33 33 33 33 33 33 33 33 33 33
11 33 33 33 33 33 33 33 33 33 33 33 33 33 33 33 33 33 33 33 33 33 33 33 11
11 33 33 33 33 33 33 33 33 33 33 33 33 33 33 33 33 33 33 33 33 33 33 33 11
11 33 33 33 33 33 33 33 33 33 33 33 33 33 33 33 33 33 33 33 33 33 33 33 11
11 33 3 33 33 33 33 33 33 33 33 33 33 33 33 33 33 33 33 33 33 33 33 33 11
11 33 33 33 33 33 33 33 33 33 33 33 33 33 33 33 33 33 33 33 33 33 33 33 11
11 33 33 33 33 33 33 23 33 33 33 33 33 22 33 33 33 33 33 33 33 33 33 33 11
11 33 33 33 33 33 33 33 33 33 33 33 33 33 33 33 33 33 22 33 33 33 33 33 11
11 33 33 33 33 33 33 33 33 33 33 33 33 33 33 33 33 33 33 33 33 33 33 22 11
11 33 33 33 33 33 33 33 33 33 33 33 33 33 33 33 33 33 33 33 33 33 33 33 11
11 33 33 33 33 33 33 33 33 33 33 33 33 33 33 33 33 33 33 33 33 33 33 33 11
11 33 33 33 33 33 33 33 33 33 33 33 33 33 33 33 33 33 33 33 33 33 33 33 11
11 1 1 1 1 1 1 1 1 1 1 1 1 1 1 1 1 1 1 1 1 1 1 1 11
11 14 15 16 17 18 19 14 15 16 17 18 19 14 15 16 17 18 19 14 15 16 17 18 11
11 15 16 17 18 19 14 15 16 17 18 19 20 15 16 17 18 19 20 15 16 17 18 19 11
11 16 17 18 19 20 15 16 17 18 19 20 15 16 17 18 19 20 15 16 17 18 19 20 11
11 18 19 14 15 16 17 18 19 14 15 16 17 18 19 14 15 16 17 18 19 14 15 16 11
11 17 18 19 20 15 16 17 18 19 20 15 16 17 18 19 14 15 16 17 18 19 20 15 11
11 16 17 18 19 14 15 16 17 18 19 14 15 16 17 18 19 14 15 16 17 18 19 14 11
11 14 15 16 17 18 19 14 15 16 17 18 19 14 15 16 17 18 19 14 15 16 17 18 11
11 5 5 5 5 5 5 5 5 5 5 5 5 5 5 5 5 5 5 5 5 5 5 5 11