17 13
1 3 1 1 1 1 1 1 1 1 1 1 1 1 1 1 1
1 1 1 1 1 1 1 1 1 1 1 1 1 1 1 1 1
1 1 1 1 1 1 1 1 1 1 1 1 1 1 1 1 1
1 1 1 1 1 1 1 1 1 1 1 1 1 1 8 8 8
1 1 1 1 1 1 1 1 1 1 1 1 1 8 8 8 8
1 1 1 1 1 1 1 1 1 1 1 1 1 1 1 7 6
1 1 1 1 1 1 1 1 1 1 1 1 1 1 5 4 1
1 1 1 1 1 1 1 1 1 1 1 1 1 1 1 7 1
16 1 1 1 1 1 1 1 1 1 1 9 0 0 0 0 0
16 16 10 1 0 0 14 14 14 0 0 0 0 2 2 2 2
0 0 0 0 0 2 15 15 15 2 2 2 2 2 2 2 2
2 2 2 2 2 2 15 15 15 2 2 2 2 2 2 2 2
2 2 2 2 2 2 2 2 2 2 2 2 2 2 2 2 2